year,name,Pop,HH,HHpop,GQ
2020,King,2225064,900061,2187190,37874
2023,King,2262713,927817,2221614,41099
2020,Kitsap,268945,105758,260444,8501
2023,Kitsap,276581,107264,269133,7448
2020,Pierce,891862,330999,872412,19450
2023,Pierce,924106,346708,903155,20951
2020,Snohomish,811572,298815,800117,11455
2023,Snohomish,834648,311825,824108,10540
2020,Region,4197443,1635633,4120163,77280
2023,Region,4298048,1693614,4218010,80038
